NO      textures/Luffy.xpm
SO 			textures/Boat.xpm
EA  	 	 	textures/Logo_black.xpm
WE textures/Logo_white.xpm











































































































































































































































































































































































































































































































































































































































































































































































































































































































































F 164,169,20
C 153,204,255

    11111
    10001
    10S01
    10001
111111111111