NO       textures/wet_sponge.xpm
SO textures/wet_sponge.xpm
WE textures/wet_sponge.xpm
EA textures/wet_sponge.xpm

F 164,169,20
C 153,204,255

111
101000001000000000001
1010101010111111100011
100010100010000010001
111110101111                                                           101011111111101
100000101000101000001
101111101011101
111111
101000001010100000101
101011111        010111110101
101010001010100010101
10111010101  0101010101
100000101010001010001
111111101011111011101
100000101000    100010001
101110101110101110111
10100010    0000100010101
101011111111111010101
1    00010000000000010001
           101010111011111111101
1N1000001000000000001
111111111111111111111