NO      textures/1.xpm
SO 			textures/2.xpm
EA  	 	 	textures/3.xpm
WE textures/3.xpm

F 164,169,20
C 153,204,255

     1111111     
     1000001     
     1001001     
     1001001     
     1001001     
11111100100111111
10000000000000001
10110011111001101
10100010001000101
11111001010011111
1N000000000000001
11111100100111111
     1001001     
     1001001     
     1001001     
     100001     
     1111111     