NO      textures/1.xpm
SO 			textures/2.xpm
EA  	 	 	textures/4.xpm
WE textures/3.xpm

F 164,169,20
C 153,204,255

11111     11111
10001     10001
100011   110001
 110001 100011
   100010001
    100S001
   100010001
 110001 100011
100011   110001
10001     10001
11111     11111