NO      textures/1.xpm
SO 			textures/2.xpm
EA  	 	 	textures/4.xpm
WE textures/3.xpm

F 164,169,20
C 153,204,255

11111111111111111111111111111
10001110020000000002000000001
10N02000111111111111111111101
10001010000001111100000001111
11111210000000011111112111111
10020011100000000000000011111
11111211000011111100011111111
11111011112111111112111111111
11111001100000000010111111111
11111100001111111020111111111
11111111111111111111111111111