NO      textures/1.xpm
SO 			textures/2.xpm
EA  	 	 	textures/4.xpm
WE textures/3.xpm

F 164,169,20
C 153,204,255

11111111111111111
10000000000000001
10000000000000001
10000000000000001
10000000000000001
10000000000000001
10000000000000001
10000000000000001
10000000000000001
10000000000000001
1N000000000000001
11111111111111111
