NO      textures/faces.xpm
SO 			textures/sponge.xpm
EA  	 	 	textures/portal.xpm
WE textures/maxinose.xpm

F 164,169,20
C 153,204,255



    11111111111
    10000000001
    10000000001
    10000S00001
    10000000001
    10000000001
1111111111111111111