NO      textures/door_open.xpm
SO 			textures/sponge.xpm
EA  	 	 	textures/portal.xpm
WE textures/door_close.xpm

F 164,169,20
C 153,204,255



    11111111111
    110000000D1
    10100000101
    10010001001
    10001010001
    10000100001
    10000000001
    10000S00001
    10000000001
    10000000001
1111111111111111111