NO      textures/luffy.xpm
SO 			textures/sponge.xpm
EA  	 	 	textures/portal.xpm
WE textures/maxinose.xpm

F 164,169,20
C 153,204,255



111111111111111111111
100000000000000000001
100000000000000000001
100000000000000000001
100000000000000000001
100000000000000000001
100000000000000000001
100000000000000000001
100000000000000000001
100000000001000000001
100000000001000000001
100000000111110000001
100000000001000000001
100000000001000000001
100000000000000000001
100000000000000000001
10000000000N000000001
100000000000000000001
100000000000000000001
100000000000000000001
100000000000000000001
111111111111111111111