NO     textures/Logo_black.xpm
SO 			textures/Logo_white.xpm
EA  	 	 	 textures/Luffy.xpm
WE textures/Boat.xpm

F 164,169,20
C 153,204,255

1111111111111111111111111111111111
1000000000000000000000000000000001
1001111111111111111111111111111111
1000100000100000000000001111110011
1000010000010010000000011111100001
1000001000110010010000111000000111
100001111D111111010000000000010111
10001E0000000000000000000000000001
10011111111D111111111111111D111011
1100001100001000000011111100111111
1111100001000011101000000000000111
11000001011000011111111111111D1111
1110000101110000010010000000001111
1000000000000011110010110111100011
1111111111111111111110111111111111
100000000000000000000D000000001111
1111111111111111111111111111111111