NO      textures/faces.xpm
SO 			textures/sponge.xpm
EA  	 	 	textures/portal.xpm
WE textures/maxinose.xpm

F 164,169,20
C 153,204,255



    111111
    100011
    10S01D
    100011
1111111111111
